8;8
O#OOOOOO
O######O
OOOOO#OO
####O##O
OOOOOO#O
O####O#O
OOOO#OOO
###OOO#O