5 10
0000000100
0000100100
0011100110
0010100000
0010000000